wwwwwwwwwwwwwwwwwwwwwww
w.....................w
w.....................w
wnm.m...m.m.m...m.m.m.w
wm.m...m.m.m...m.m.m.nw
wnm.m...m.m.m...m.m.m.w
w.....................w
wb.b.m.m.m.m.nb.b.b.b.w
w.....................w
w.....................w
w.....................w
w.....................w
w.....................w
w.....................w
w.....................w
w.....................w
w.....................w
w.....................w
w.........A...........w
w.....................w