wwwwwwwwwwwwwwwwwwwwwww
w.....................w
w.....................w
w.....................w
w.....................w
wm.m.m...........m.m.mw
wm.m.m...m.m.m...m.m.mw
wm.m.m...m.m.m...m.m.mw
w.....................w
w.....................w
w......b.b.b.b.b......w
w.....................w
w.....................w
w.....................w
w.....................w
w.....................w
w.....................w
w.....................w
w..........A..........w
w.....................w