wwwwwwwwwwwwwwwwwwwwwww
w.....................w
w...m.............m...w
w.....................w
wm.m.m.m.m...m.m.m.m..w
w.m.m.m.m.m.m.m.m.m.m.w
wm.m.m.m.m.m.m.m.m.m..w
wm.m.m...m.m.m...m.m.mw
w.....................w
w.....................w
w.....................w
w.....................w
w.....................w
w.....................w
w.....................w
w.....................w
w.....................w
w.....................w
w..........A..........w
w.....................w