wwwwwwwwwwwwwwwwwwwwwww
w.....................w
w.....................w
wm.m.b.m.m.m.m.b.m.m.nw
wnm.m.m.m.b.m.m.m.m.m.w
wnm.m.m.m.m.m.m.m.m.m.w
w.....................w
w.....................w
w.....................w
w.....................w
w.....................w
w.....................w
w.....................w
w.....................w
w.....................w
w.....................w
w.....................w
w.....................w
w.........A...........w
w.....................w